County,Zip Code,Active,Inactive,Judge,Not Eligible,Total
Alameda,94501,234,122,1,22,379
Alameda,94502,87,53,0,8,148
Alameda,94512,0,0,1,0,1
Alameda,94536,40,29,0,4,73
Alameda,94537,10,2,0,0,12
Alameda,94538,211,25,5,7,248
Alameda,94539,75,21,0,9,105
Alameda,94540,5,0,0,1,6
Alameda,94541,76,27,0,7,110
Alameda,94542,18,9,0,4,31
Alameda,94543,1,0,0,0,1
Alameda,94544,33,16,13,5,67
Alameda,94545,29,7,1,1,38
Alameda,94546,65,31,0,6,102
Alameda,94550,45,21,0,4,70
Alameda,94551,46,18,0,1,65
Alameda,94552,15,24,0,3,42
Alameda,94555,21,7,0,3,31
Alameda,94560,73,7,0,1,81
Alameda,94566,131,36,0,15,182
Alameda,94568,115,28,4,4,151
Alameda,94577,94,27,0,5,126
Alameda,94578,12,9,1,2,24
Alameda,94579,8,3,0,0,11
Alameda,94580,3,10,0,1,14
Alameda,94586,3,3,0,1,7
Alameda,94587,32,7,0,3,42
Alameda,94588,318,31,2,8,359
Alameda,94601,60,8,0,5,73
Alameda,94602,109,81,0,25,215
Alameda,94603,1,0,0,0,1
Alameda,94604,65,6,0,1,72
Alameda,94605,60,56,0,12,128
Alameda,94606,48,21,0,9,78
Alameda,94608,288,48,0,13,349
Alameda,94609,110,37,0,16,163
Alameda,94610,185,177,0,36,398
Alameda,94611,296,389,0,59,744
Alameda,94613,1,1,0,0,2
Alameda,94614,0,1,0,0,1
Alameda,94615,1,0,0,0,1
Alameda,94617,0,2,0,0,2
Alameda,94618,115,156,0,20,291
Alameda,94619,52,58,0,11,121
Alameda,94620,9,6,0,2,17
Alameda,94621,97,6,0,3,106
Alameda,94623,12,1,0,0,13
Alameda,94627,0,0,0,1,1
Alameda,94661,7,9,0,0,16
Alameda,94662,8,4,0,0,12
Alameda,94701,12,7,0,0,19
Alameda,94702,45,44,0,7,96
Alameda,94703,72,77,0,11,160
Alameda,94704,221,44,0,18,283
Alameda,94705,177,174,0,25,376
Alameda,94706,76,69,0,8,153
Alameda,94707,150,209,0,19,378
Alameda,94708,63,129,0,23,215
Alameda,94709,86,58,0,12,156
Alameda,94710,151,29,0,6,186
Alameda,94712,1,1,0,0,2
Alameda,94720,77,33,0,9,119
Alpine,96120,4,2,2,0,8
Amador,95601,1,3,0,1,5
Amador,95629,0,1,0,1,2
Amador,95640,5,5,0,0,10
Amador,95642,37,7,2,2,48
Amador,95665,3,3,0,0,6
Amador,95666,3,5,0,2,10
Amador,95669,3,6,0,0,9
Amador,95685,19,6,0,2,27
Amador,95689,1,1,0,0,2
Butte,95914,1,0,0,0,1
Butte,95926,65,26,1,10,102
Butte,95927,28,7,0,3,38
Butte,95928,100,29,0,7,136
Butte,95929,5,0,0,0,5
Butte,95938,5,4,0,0,9
Butte,95942,4,5,0,0,9
Butte,95948,4,2,0,0,6
Butte,95954,0,4,0,0,4
Butte,95965,60,7,11,3,81
Butte,95966,6,11,0,2,19
Butte,95967,3,2,0,5,10
Butte,95968,1,0,0,0,1
Butte,95969,4,9,0,2,15
Butte,95973,51,18,0,4,73
Calaveras,95221,1,1,0,0,2
Calaveras,95222,5,1,0,1,7
Calaveras,95223,2,5,0,1,8
Calaveras,95228,5,1,0,0,6
Calaveras,95245,3,2,0,0,5
Calaveras,95246,4,2,0,0,6
Calaveras,95247,9,8,0,0,17
Calaveras,95248,0,1,0,0,1
Calaveras,95249,26,9,2,1,38
Calaveras,95251,0,1,0,1,2
Calaveras,95252,4,3,0,1,8
Colusa,95912,0,2,0,0,2
Colusa,95932,18,4,2,0,24
Colusa,95970,0,0,0,1,1
Colusa,95987,1,2,0,0,3
Contra Costa,94505,15,6,0,2,23
Contra Costa,94506,75,59,0,7,141
Contra Costa,94507,83,86,0,12,181
Contra Costa,94509,23,9,0,7,39
Contra Costa,94511,1,3,0,1,5
Contra Costa,94513,60,22,0,5,87
Contra Costa,94516,2,0,0,0,2
Contra Costa,94517,21,18,0,5,44
Contra Costa,94518,21,22,0,2,45
Contra Costa,94519,24,11,0,1,36
Contra Costa,94520,217,19,0,10,246
Contra Costa,94521,25,34,0,6,65
Contra Costa,94522,5,1,0,0,6
Contra Costa,94523,186,54,0,18,258
Contra Costa,94524,13,1,0,0,14
Contra Costa,94525,3,6,0,1,10
Contra Costa,94526,157,94,0,19,270
Contra Costa,94528,9,12,0,0,21
Contra Costa,94530,78,100,0,21,199
Contra Costa,94531,20,8,0,3,31
Contra Costa,94547,31,15,0,3,49
Contra Costa,94549,268,203,1,31,503
Contra Costa,94553,338,57,23,18,436
Contra Costa,94556,91,122,0,15,228
Contra Costa,94561,7,9,0,2,18
Contra Costa,94563,223,202,0,38,463
Contra Costa,94564,22,15,0,4,41
Contra Costa,94565,27,11,2,3,43
Contra Costa,94570,14,12,0,0,26
Contra Costa,94572,2,4,0,0,6
Contra Costa,94575,0,3,0,0,3
Contra Costa,94582,44,29,0,2,75
Contra Costa,94583,335,54,0,22,411
Contra Costa,94595,70,124,0,16,210
Contra Costa,94597,229,63,1,11,304
Contra Costa,94598,219,110,0,17,346
Contra Costa,94707,1,1,0,0,2
Contra Costa,94801,60,22,0,1,83
Contra Costa,94802,0,0,0,2,2
Contra Costa,94803,17,15,0,1,33
Contra Costa,94804,39,24,0,9,72
Contra Costa,94805,28,25,7,6,66
Contra Costa,94806,24,11,0,5,40
Contra Costa,94807,2,2,0,0,4
Contra Costa,94808,0,1,0,0,1
Contra Costa,94820,7,3,0,0,10
Contra Costa,94850,1,2,0,0,3
Del Norte,95531,37,13,2,2,54
Del Norte,95548,10,1,0,0,11
El Dorado,95613,1,0,0,1,2
El Dorado,95614,4,7,0,0,11
El Dorado,95619,6,6,0,0,12
El Dorado,95623,6,9,0,1,16
El Dorado,95633,2,1,0,1,4
El Dorado,95634,0,3,0,0,3
El Dorado,95635,0,2,0,1,3
El Dorado,95636,0,2,0,1,3
El Dorado,95651,2,1,0,1,4
El Dorado,95656,1,1,0,0,2
El Dorado,95664,3,2,0,0,5
El Dorado,95667,88,40,6,7,141
El Dorado,95672,7,4,0,1,12
El Dorado,95682,47,35,1,10,93
El Dorado,95684,1,3,0,0,4
El Dorado,95705,0,0,0,1,1
El Dorado,95709,4,8,0,2,14
El Dorado,95726,4,6,0,0,10
El Dorado,95729,0,0,0,1,1
El Dorado,95762,122,78,0,7,207
El Dorado,96150,41,19,1,2,63
El Dorado,96151,7,6,0,1,14
El Dorado,96155,2,2,0,0,4
El Dorado,96158,5,2,0,1,8
Fresno,93210,2,2,0,1,5
Fresno,93242,0,1,0,0,1
Fresno,93602,1,1,0,0,2
Fresno,93611,50,22,0,4,76
Fresno,93612,39,10,0,3,52
Fresno,93613,14,4,0,2,20
Fresno,93619,20,21,0,4,45
Fresno,93621,0,1,0,0,1
Fresno,93622,4,0,0,1,5
Fresno,93624,0,1,0,0,1
Fresno,93625,4,1,0,0,5
Fresno,93626,4,2,0,0,6
Fresno,93630,3,1,0,0,4
Fresno,93631,5,1,0,2,8
Fresno,93641,1,0,0,0,1
Fresno,93646,1,0,0,0,1
Fresno,93648,0,1,0,0,1
Fresno,93649,0,1,0,1,2
Fresno,93650,18,1,0,3,22
Fresno,93651,1,1,0,0,2
Fresno,93654,5,5,0,0,10
Fresno,93657,8,3,0,2,13
Fresno,93662,4,2,0,1,7
Fresno,93664,2,0,0,1,3
Fresno,93667,2,1,0,0,3
Fresno,93675,3,1,0,0,4
Fresno,93701,1,1,0,0,2
Fresno,93702,9,3,0,1,13
Fresno,93703,8,0,0,1,9
Fresno,93704,249,45,0,18,312
Fresno,93705,5,3,0,0,8
Fresno,93706,3,1,0,1,5
Fresno,93707,5,0,0,0,5
Fresno,93708,4,1,0,0,5
Fresno,93709,3,0,0,0,3
Fresno,93710,89,14,0,2,105
Fresno,93711,324,80,1,12,417
Fresno,93712,1,0,0,0,1
Fresno,93714,5,0,0,0,5
Fresno,93715,5,0,0,0,5
Fresno,93716,1,0,0,1,2
Fresno,93717,1,0,0,0,1
Fresno,93720,262,36,0,10,308
Fresno,93722,23,6,0,3,32
Fresno,93723,2,2,0,1,5
Fresno,93724,16,5,39,1,61
Fresno,93725,10,1,0,0,11
Fresno,93726,18,6,0,4,28
Fresno,93727,25,10,0,0,35
Fresno,93728,12,3,0,1,16
Fresno,93729,74,14,0,3,91
Fresno,93730,14,11,0,1,26
Fresno,93737,4,1,0,0,5
Fresno,93740,1,1,0,0,2
Fresno,93744,3,2,0,3,8
Fresno,93745,1,0,0,0,1
Fresno,93747,7,2,0,0,9
Fresno,93755,18,5,0,3,26
Fresno,93765,1,0,0,0,1
Fresno,93773,0,2,0,0,2
Fresno,93775,1,0,0,0,1
Fresno,93778,1,0,0,0,1
Fresno,93779,2,0,0,0,2
Fresno,93791,1,0,0,0,1
Glenn,95939,0,1,0,0,1
Glenn,95963,4,4,0,1,9
Glenn,95988,12,6,2,0,20
Humboldt,95501,115,21,6,7,149
Humboldt,95502,33,16,0,1,50
Humboldt,95503,8,19,0,5,32
Humboldt,95511,1,0,0,0,1
Humboldt,95518,3,3,0,2,8
Humboldt,95519,8,6,0,3,17
Humboldt,95521,23,19,0,2,44
Humboldt,95524,3,5,0,0,8
Humboldt,95525,0,2,0,0,2
Humboldt,95528,0,1,0,0,1
Humboldt,95534,0,3,0,1,4
Humboldt,95536,4,1,0,1,6
Humboldt,95540,4,3,0,0,7
Humboldt,95542,2,0,0,0,2
Humboldt,95545,0,1,0,0,1
Humboldt,95546,1,0,0,0,1
Humboldt,95547,1,2,0,0,3
Humboldt,95551,1,0,0,0,1
Humboldt,95553,1,1,0,0,2
Humboldt,95556,0,0,0,1,1
Humboldt,95560,3,1,0,1,5
Humboldt,95570,6,7,0,1,14
Humboldt,95573,2,3,0,0,5
Humboldt,95589,3,1,0,0,4
Imperial,92227,7,2,0,0,9
Imperial,92231,2,1,0,0,3
Imperial,92232,2,1,0,0,3
Imperial,92243,96,14,9,9,128
Imperial,92244,4,6,1,1,12
Imperial,92249,1,0,0,0,1
Imperial,92250,0,3,0,1,4
Imperial,92251,15,1,0,0,16
Imperial,92273,0,1,0,0,1
Imperial,92281,1,0,0,0,1
Imperial,92283,1,0,0,0,1
Inyo,92389,1,0,0,0,1
Inyo,93513,0,2,0,1,3
Inyo,93514,17,13,1,0,31
Inyo,93515,5,1,1,1,8
Inyo,93526,8,0,0,0,8
Inyo,93545,0,1,0,1,2
Inyo,93549,1,0,0,0,1
Kern,93203,3,1,0,0,4
Kern,93205,0,0,0,1,1
Kern,93215,7,0,0,0,7
Kern,93216,0,1,0,0,1
Kern,93222,4,7,0,1,12
Kern,93225,3,0,0,0,3
Kern,93226,1,1,0,0,2
Kern,93238,4,3,0,0,7
Kern,93240,2,2,0,0,4
Kern,93241,2,1,0,0,3
Kern,93243,1,1,0,0,2
Kern,93263,4,3,1,0,8
Kern,93268,0,1,0,0,1
Kern,93280,1,2,0,0,3
Kern,93283,0,3,0,0,3
Kern,93285,2,0,0,2,4
Kern,93287,0,0,0,1,1
Kern,93301,393,18,32,11,454
Kern,93302,3,0,0,2,5
Kern,93303,15,4,0,1,20
Kern,93304,35,2,0,4,41
Kern,93305,12,3,1,3,19
Kern,93306,29,21,0,2,52
Kern,93307,9,1,0,1,11
Kern,93308,19,12,0,2,33
Kern,93309,95,28,0,5,128
Kern,93311,101,22,0,2,125
Kern,93312,17,15,0,0,32
Kern,93313,11,3,0,1,15
Kern,93314,6,14,0,0,20
Kern,93380,1,3,0,0,4
Kern,93383,1,0,0,1,2
Kern,93384,1,0,0,0,1
Kern,93385,1,0,0,1,2
Kern,93386,2,2,0,0,4
Kern,93387,1,0,0,0,1
Kern,93389,14,5,0,1,20
Kern,93390,6,7,0,1,14
Kern,93501,5,1,0,0,6
Kern,93505,1,1,0,0,2
Kern,93516,0,0,0,1,1
Kern,93518,2,0,0,1,3
Kern,93524,2,0,0,0,2
Kern,93531,2,3,0,0,5
Kern,93555,17,4,3,2,26
Kern,93556,4,2,0,1,7
Kern,93560,3,0,0,1,4
Kern,93561,12,15,0,1,28
Kern,93581,6,3,0,0,9
Kings,93212,1,0,0,0,1
Kings,93230,88,15,9,3,115
Kings,93232,5,1,0,0,6
Kings,93245,3,4,0,0,7
Kings,93266,1,0,0,0,1
Lake,95422,7,4,0,2,13
Lake,95423,2,0,0,0,2
Lake,95424,1,0,0,0,1
Lake,95426,2,1,0,0,3
Lake,95443,0,0,0,1,1
Lake,95451,8,6,0,2,16
Lake,95453,42,18,4,5,69
Lake,95457,1,4,0,0,5
Lake,95458,0,1,0,1,2
Lake,95461,5,4,0,1,10
Lake,95464,1,1,0,0,2
Lake,95467,0,2,0,2,4
Lake,95485,1,1,0,0,2
Lassen,96114,1,0,0,0,1
Lassen,96127,2,0,1,0,3
Lassen,96128,1,1,0,0,2
Lassen,96130,15,4,1,1,21
Lassen,96137,1,2,0,0,3
Los Angeles,90001,4,2,0,0,6
Los Angeles,90002,1,0,0,0,1
Los Angeles,90003,20,0,0,1,21
Los Angeles,90004,169,78,0,19,266
Los Angeles,90005,147,19,7,19,192
Los Angeles,90006,28,7,1,6,42
Los Angeles,90007,69,12,34,3,118
Los Angeles,90008,54,21,0,8,83
Los Angeles,90009,18,10,0,1,29
Los Angeles,90011,9,1,0,3,13
Los Angeles,90014,357,9,0,9,375
Los Angeles,90015,369,29,0,17,415
Los Angeles,90016,48,14,0,5,67
Los Angeles,90018,25,8,0,6,39
Los Angeles,90019,108,48,0,14,170
Los Angeles,90020,78,37,0,8,123
Los Angeles,90021,124,5,0,3,132
Los Angeles,90022,77,5,6,2,90
Los Angeles,90023,10,1,0,0,11
Los Angeles,90026,107,40,0,13,160
Los Angeles,90027,155,93,2,24,274
Los Angeles,90028,426,21,1,13,461
Los Angeles,90029,40,10,0,1,51
Los Angeles,90031,29,3,0,2,34
Los Angeles,90032,28,5,0,2,35
Los Angeles,90033,25,5,2,0,32
Los Angeles,90034,230,91,0,34,355
Los Angeles,90035,175,73,0,22,270
Los Angeles,90036,364,88,0,41,493
Los Angeles,90037,10,1,0,3,14
Los Angeles,90038,112,5,0,11,128
Los Angeles,90039,93,49,0,14,156
Los Angeles,90040,70,4,0,5,79
Los Angeles,90041,72,32,0,6,110
Los Angeles,90042,48,20,0,4,72
Los Angeles,90043,37,27,0,3,67
Los Angeles,90044,13,1,0,0,14
Los Angeles,90046,256,95,0,38,389
Los Angeles,90047,9,5,0,4,18
Los Angeles,90048,381,71,0,28,480
Los Angeles,90049,475,355,0,74,904
Los Angeles,90050,6,4,0,1,11
Los Angeles,90051,2,2,0,2,6
Los Angeles,90053,5,1,0,0,6
Los Angeles,90054,14,1,0,0,15
Los Angeles,90055,0,1,0,1,2
Los Angeles,90056,42,28,0,1,71
Los Angeles,90057,64,8,0,4,76
Los Angeles,90058,24,5,0,2,31
Los Angeles,90059,2,1,0,0,3
Los Angeles,90060,1,0,0,0,1
Los Angeles,90061,4,1,0,0,5
Los Angeles,90062,3,1,0,3,7
Los Angeles,90063,12,1,0,2,15
Los Angeles,90065,69,36,2,7,114
Los Angeles,90066,184,90,0,27,301
Los Angeles,90068,121,80,0,22,223
Los Angeles,90069,342,81,0,41,464
Los Angeles,90070,1,0,0,0,1
Los Angeles,90073,8,3,0,0,11
Los Angeles,90074,1,0,0,0,1
Los Angeles,90075,4,1,0,0,5
Los Angeles,90076,10,2,0,0,12
Los Angeles,90077,101,101,0,23,225
Los Angeles,90078,11,4,0,1,16
Los Angeles,90079,0,0,0,1,1
Los Angeles,90081,9,0,0,1,10
Los Angeles,90082,2,0,0,0,2
Los Angeles,90083,4,0,0,0,4
Los Angeles,90086,20,4,0,3,27
Los Angeles,90087,7,0,0,0,7
Los Angeles,90089,61,14,0,4,79
Los Angeles,90090,3,0,0,0,3
Los Angeles,90091,1,0,0,1,2
Los Angeles,90093,6,1,0,2,9
Los Angeles,90094,143,30,0,5,178
Los Angeles,90095,85,36,0,4,125
Los Angeles,90099,1,0,0,0,1
Los Angeles,90201,11,0,0,1,12
Los Angeles,90209,24,10,0,3,37
Los Angeles,90213,45,10,0,4,59
Los Angeles,90220,71,9,27,2,109
Los Angeles,90221,5,1,0,1,7
Los Angeles,90222,7,1,0,0,8
Los Angeles,90230,262,56,0,21,339
Los Angeles,90231,13,5,0,1,19
Los Angeles,90232,426,50,0,8,484
Los Angeles,90239,4,0,0,1,5
Los Angeles,90240,35,11,0,2,48
Los Angeles,90241,69,12,0,7,88
Los Angeles,90242,27,9,12,0,48
Los Angeles,90247,21,8,0,5,34
Los Angeles,90248,48,9,0,2,59
Los Angeles,90249,13,5,0,2,20
Los Angeles,90250,54,16,0,6,76
Los Angeles,90251,1,0,0,0,1
Los Angeles,90254,179,53,0,11,243
Los Angeles,90255,23,1,0,0,24
Los Angeles,90260,25,2,0,5,32
Los Angeles,90262,4,0,0,3,7
Los Angeles,90263,29,9,0,1,39
Los Angeles,90264,6,4,0,0,10
Los Angeles,90265,155,102,0,18,275
Los Angeles,90267,22,6,0,0,28
Los Angeles,90270,2,0,0,0,2
Los Angeles,90272,288,280,0,51,619
Los Angeles,90274,229,170,0,23,422
Los Angeles,90275,137,147,0,12,296
Los Angeles,90277,196,91,0,18,305
Los Angeles,90278,126,33,0,16,175
Los Angeles,90280,14,2,0,0,16
Los Angeles,90290,13,18,0,4,35
Los Angeles,90291,101,67,0,28,196
Los Angeles,90292,304,103,0,26,433
Los Angeles,90293,87,37,0,15,139
Los Angeles,90294,6,4,0,0,10
Los Angeles,90295,11,8,0,4,23
Los Angeles,90296,7,1,0,0,8
Los Angeles,90301,68,14,6,5,93
Los Angeles,90302,24,3,0,0,27
Los Angeles,90303,6,0,0,1,7
Los Angeles,90304,5,1,0,0,6
Los Angeles,90305,19,2,0,3,24
Los Angeles,90306,0,0,0,1,1
Los Angeles,90308,1,0,0,0,1
Los Angeles,90310,0,0,0,2,2
Los Angeles,90312,1,0,0,0,1
Los Angeles,90402,90,133,0,22,245
Los Angeles,90403,305,117,0,41,463
Los Angeles,90404,330,38,0,13,381
Los Angeles,90405,323,121,0,26,470
Los Angeles,90406,25,11,0,2,38
Los Angeles,90407,4,2,0,0,6
Los Angeles,90408,10,4,0,1,15
Los Angeles,90409,17,2,0,0,19
Los Angeles,90501,161,21,0,4,186
Los Angeles,90502,79,6,0,2,87
Los Angeles,90503,366,55,15,15,451
Los Angeles,90504,55,20,0,9,84
Los Angeles,90505,144,39,0,11,194
Los Angeles,90506,3,2,0,0,5
Los Angeles,90507,1,0,0,0,1
Los Angeles,90508,0,2,0,0,2
Los Angeles,90509,0,0,0,2,2
Los Angeles,90510,8,4,0,1,13
Los Angeles,90601,58,18,0,5,81
Los Angeles,90602,63,10,2,4,79
Los Angeles,90603,12,12,0,3,27
Los Angeles,90604,6,5,0,1,12
Los Angeles,90605,21,4,0,2,27
Los Angeles,90606,2,2,0,3,7
Los Angeles,90607,3,5,0,0,8
Los Angeles,90608,3,3,0,0,6
Los Angeles,90609,4,2,0,0,6
Los Angeles,90637,5,1,0,0,6
Los Angeles,90638,41,12,0,8,61
Los Angeles,90639,2,1,0,0,3
Los Angeles,90640,68,13,0,8,89
Los Angeles,90650,80,17,10,6,113
Los Angeles,90651,1,0,0,0,1
Los Angeles,90652,1,0,0,0,1
Los Angeles,90660,12,4,0,2,18
Los Angeles,90670,47,4,0,1,52
Los Angeles,90701,8,5,0,1,14
Los Angeles,90702,2,0,0,1,3
Los Angeles,90703,266,30,0,7,303
Los Angeles,90704,2,1,0,1,4
Los Angeles,90706,31,8,8,0,47
Los Angeles,90707,1,2,0,0,3
Los Angeles,90710,8,5,0,1,14
Los Angeles,90711,2,0,0,0,2
Los Angeles,90712,22,8,0,3,33
Los Angeles,90713,6,6,0,2,14
Los Angeles,90714,4,3,0,1,8
Los Angeles,90715,7,2,0,0,9
Los Angeles,90716,0,0,0,1,1
Los Angeles,90717,19,7,0,1,27
Los Angeles,90723,16,5,0,2,23
Los Angeles,90731,95,31,0,2,128
Los Angeles,90732,35,41,0,4,80
Los Angeles,90733,5,0,0,0,5
Los Angeles,90734,12,4,0,1,17
Los Angeles,90744,6,3,0,1,10
Los Angeles,90745,18,7,0,6,31
Los Angeles,90746,30,6,0,2,38
Los Angeles,90747,2,0,0,0,2
Los Angeles,90748,1,0,0,0,1
Los Angeles,90749,4,0,0,0,4
Los Angeles,90755,15,6,0,0,21
Los Angeles,90801,32,2,0,0,34
Los Angeles,90803,129,119,0,22,270
Los Angeles,90804,90,12,0,7,109
Los Angeles,90805,14,1,0,6,21
Los Angeles,90806,72,11,0,1,84
Los Angeles,90807,161,45,0,9,215
Los Angeles,90808,75,38,0,15,128
Los Angeles,90809,6,3,0,1,10
Los Angeles,90810,26,6,0,3,35
Los Angeles,90813,14,4,0,0,18
Los Angeles,90814,35,24,0,5,64
Los Angeles,90815,96,53,0,16,165
Los Angeles,90831,152,2,0,1,155
Los Angeles,90832,4,1,0,1,6
Los Angeles,90840,3,3,0,1,7
Los Angeles,90853,5,8,0,0,13
Los Angeles,90895,2,0,0,0,2
Los Angeles,91001,74,79,0,10,163
Los Angeles,91003,6,3,0,2,11
Los Angeles,91006,122,37,0,8,167
Los Angeles,91007,39,30,0,8,77
Los Angeles,91008,4,4,0,0,8
Los Angeles,91009,2,0,0,0,2
Los Angeles,91010,26,13,0,3,42
Los Angeles,91011,147,130,0,14,291
Los Angeles,91012,29,18,0,1,48
Los Angeles,91016,109,26,0,7,142
Los Angeles,91017,6,5,0,1,12
Los Angeles,91020,41,15,0,4,60
Los Angeles,91021,14,4,0,1,19
Los Angeles,91024,48,38,0,5,91
Los Angeles,91025,13,7,0,3,23
Los Angeles,91030,168,77,0,17,262
Los Angeles,91031,41,18,0,3,62
Los Angeles,91040,16,12,0,4,32
Los Angeles,91041,6,0,0,2,8
Los Angeles,91042,10,17,0,5,32
Los Angeles,91043,2,5,0,0,7
Los Angeles,91046,4,3,0,1,8
Los Angeles,91066,11,8,0,0,19
Los Angeles,91077,7,2,0,1,10
Los Angeles,91100,0,1,0,0,1
Los Angeles,91102,15,5,0,0,20
Los Angeles,91103,160,51,0,9,220
Los Angeles,91104,58,49,0,8,115
Los Angeles,91105,269,108,8,21,406
Los Angeles,91106,188,69,0,12,269
Los Angeles,91107,190,65,0,8,263
Los Angeles,91108,122,88,0,9,219
Los Angeles,91109,42,11,0,6,59
Los Angeles,91114,4,1,0,0,5
Los Angeles,91115,5,4,0,1,10
Los Angeles,91116,7,6,0,0,13
Los Angeles,91117,15,9,0,1,25
Los Angeles,91118,19,11,0,1,31
Los Angeles,91124,3,1,0,0,4
Los Angeles,91125,6,3,0,0,9
Los Angeles,91188,37,3,0,0,40
Los Angeles,91201,76,16,0,2,94
Los Angeles,91202,134,36,0,6,176
Los Angeles,91204,47,3,0,1,51
Los Angeles,91205,95,12,0,1,108
Los Angeles,91206,89,34,6,11,140
Los Angeles,91207,27,29,0,6,62
Los Angeles,91208,42,54,0,5,101
Los Angeles,91209,22,2,0,5,29
Los Angeles,91210,65,6,0,4,75
Los Angeles,91214,96,50,0,9,155
Los Angeles,91221,6,1,0,1,8
Los Angeles,91222,7,4,0,0,11
Los Angeles,91224,9,3,0,0,12
Los Angeles,91225,5,1,0,0,6
Los Angeles,91226,10,3,0,0,13
Los Angeles,91301,319,70,0,16,405
Los Angeles,91302,474,138,0,28,640
Los Angeles,91303,51,6,0,7,64
Los Angeles,91304,58,38,0,4,100
Los Angeles,91305,1,0,0,0,1
Los Angeles,91306,20,7,0,11,38
Los Angeles,91307,78,43,0,11,132
Los Angeles,91308,6,3,0,0,9
Los Angeles,91309,3,2,0,1,6
Los Angeles,91310,1,1,0,0,2
Los Angeles,91311,152,41,10,8,211
Los Angeles,91313,11,4,0,0,15
Los Angeles,91316,198,97,0,21,316
Los Angeles,91321,32,19,0,2,53
Los Angeles,91322,5,0,0,0,5
Los Angeles,91324,89,31,0,10,130
Los Angeles,91325,59,27,0,11,97
Los Angeles,91326,106,64,0,11,181
Los Angeles,91327,14,10,0,3,27
Los Angeles,91328,3,5,0,0,8
Los Angeles,91329,3,0,0,0,3
Los Angeles,91330,4,1,0,1,6
Los Angeles,91331,47,4,0,1,52
Los Angeles,91333,0,1,0,0,1
Los Angeles,91334,1,0,0,0,1
Los Angeles,91335,34,21,0,7,62
Los Angeles,91337,4,1,0,0,5
Los Angeles,91340,49,4,11,2,66
Los Angeles,91341,1,0,0,1,2
Los Angeles,91342,29,12,1,3,45
Los Angeles,91343,29,13,0,2,44
Los Angeles,91344,75,56,0,7,138
Los Angeles,91345,17,6,0,3,26
Los Angeles,91346,2,0,0,1,3
Los Angeles,91350,28,16,0,8,52
Los Angeles,91351,12,8,0,4,24
Los Angeles,91352,10,7,0,5,22
Los Angeles,91353,2,0,0,0,2
Los Angeles,91354,31,17,0,3,51
Los Angeles,91355,225,35,3,12,275
Los Angeles,91356,194,96,0,19,309
Los Angeles,91357,20,4,0,2,26
Los Angeles,91361,19,1,0,0,20
Los Angeles,91362,5,0,0,0,5
Los Angeles,91364,313,100,0,31,444
Los Angeles,91365,31,4,0,2,37
Los Angeles,91372,16,6,0,3,25
Los Angeles,91376,25,11,0,3,39
Los Angeles,91380,15,4,0,1,20
Los Angeles,91381,44,18,0,1,63
Los Angeles,91384,11,8,0,1,20
Los Angeles,91385,3,1,0,0,4
Los Angeles,91386,6,2,0,0,8
Los Angeles,91387,31,10,0,2,43
Los Angeles,91390,8,9,0,1,18
Los Angeles,91392,4,0,0,1,5
Los Angeles,91393,2,0,0,0,2
Los Angeles,91394,12,6,0,3,21
Los Angeles,91395,1,1,0,1,3
Los Angeles,91396,3,0,0,1,4
Los Angeles,91401,226,59,31,16,332
Los Angeles,91402,16,1,0,0,17
Los Angeles,91404,1,0,1,0,2
Los Angeles,91405,35,7,0,2,44
Los Angeles,91406,80,22,0,7,109
Los Angeles,91407,3,0,0,1,4
Los Angeles,91408,1,0,0,0,1
Los Angeles,91409,22,1,0,3,26
Los Angeles,91410,1,0,0,0,1
Los Angeles,91411,119,13,0,7,139
Los Angeles,91412,3,0,0,0,3
Los Angeles,91413,27,20,0,6,53
Los Angeles,91416,21,6,0,2,29
Los Angeles,91423,263,98,0,18,379
Los Angeles,91426,27,11,0,2,40
Los Angeles,91501,14,15,0,5,34
Los Angeles,91502,190,10,4,0,204
Los Angeles,91503,10,2,0,0,12
Los Angeles,91504,76,14,0,2,92
Los Angeles,91505,409,32,1,15,457
Los Angeles,91506,76,19,0,6,101
Los Angeles,91507,1,1,0,0,2
Los Angeles,91508,2,0,0,0,2
Los Angeles,91510,17,5,0,2,24
Los Angeles,91521,199,7,0,5,211
Los Angeles,91522,94,5,0,1,100
Los Angeles,91601,64,24,0,7,95
Los Angeles,91602,78,31,0,11,120
Los Angeles,91603,7,0,0,1,8
Los Angeles,91604,291,102,2,28,423
Los Angeles,91605,15,8,0,3,26
Los Angeles,91606,39,14,0,6,59
Los Angeles,91607,99,44,0,13,156
Los Angeles,91608,163,2,0,5,170
Los Angeles,91609,1,0,0,1,2
Los Angeles,91610,14,3,0,0,17
Los Angeles,91614,13,6,0,2,21
Los Angeles,91615,1,0,0,0,1
Los Angeles,91616,4,0,0,0,4
Los Angeles,91617,7,5,0,3,15
Los Angeles,91702,23,3,0,1,27
Los Angeles,91706,19,6,0,2,27
Los Angeles,91711,174,80,0,10,264
Los Angeles,91715,5,2,0,1,8
Los Angeles,91722,9,7,0,1,17
Los Angeles,91723,54,7,0,1,62
Los Angeles,91724,21,4,0,3,28
Los Angeles,91731,52,4,5,3,64
Los Angeles,91732,4,3,0,2,9
Los Angeles,91733,12,1,0,2,15
Los Angeles,91734,4,0,0,0,4
Los Angeles,91740,38,15,0,3,56
Los Angeles,91741,42,24,0,4,70
Los Angeles,91744,11,1,0,0,12
Los Angeles,91745,36,17,0,6,59
Los Angeles,91746,47,3,0,0,50
Los Angeles,91747,3,1,0,0,4
Los Angeles,91748,94,9,0,6,109
Los Angeles,91750,42,21,0,3,66
Los Angeles,91755,18,8,0,1,27
Los Angeles,91765,178,25,0,3,206
Los Angeles,91766,84,7,17,3,111
Los Angeles,91767,5,13,0,0,18
Los Angeles,91768,38,12,0,3,53
Los Angeles,91769,9,0,0,0,9
Los Angeles,91770,139,6,0,11,156
Los Angeles,91773,68,20,0,6,94
Los Angeles,91775,25,16,0,6,47
Los Angeles,91776,62,12,0,4,78
Los Angeles,91778,10,3,0,0,13
Los Angeles,91780,21,6,0,2,29
Los Angeles,91788,11,0,0,0,11
Los Angeles,91789,103,30,0,7,140
Los Angeles,91790,61,16,11,1,89
Los Angeles,91791,67,13,0,4,84
Los Angeles,91792,11,3,0,2,16
Los Angeles,91793,3,3,0,0,6
Los Angeles,91801,121,19,10,3,153
Los Angeles,91802,13,5,0,2,20
Los Angeles,91803,41,6,0,3,50
Los Angeles,93510,11,6,0,2,19
Los Angeles,93532,0,0,0,1,1
Los Angeles,93534,152,15,32,4,203
Los Angeles,93535,5,3,0,0,8
Los Angeles,93536,18,11,0,6,35
Los Angeles,93539,3,4,0,0,7
Los Angeles,93543,2,0,0,1,3
Los Angeles,93544,0,1,0,1,2
Los Angeles,93550,10,2,0,2,14
Los Angeles,93551,36,12,0,6,54
Los Angeles,93552,3,1,0,0,4
Los Angeles,93553,1,1,0,0,2
Los Angeles,93584,1,0,0,0,1
Los Angeles,93590,3,0,0,0,3
Los Angeles,93591,1,0,0,0,1
Los Angeles,93599,1,1,0,0,2
Madera,93601,2,1,0,1,4
Madera,93604,2,2,0,0,4
Madera,93610,2,1,0,0,3
Madera,93614,7,8,0,0,15
Madera,93636,8,5,0,1,14
Madera,93637,54,8,11,1,74
Madera,93638,8,4,0,2,14
Madera,93639,2,2,0,0,4
Madera,93643,1,0,0,2,3
Madera,93644,15,10,0,1,26
Madera,93645,0,1,0,0,1
Madera,93653,0,2,0,0,2
Madera,93669,0,1,0,0,1
Marin,94901,401,156,1,22,580
Marin,94903,358,131,6,18,513
Marin,94904,83,120,0,6,209
Marin,94912,8,6,0,3,17
Marin,94913,9,6,5,0,20
Marin,94914,11,9,0,0,20
Marin,94915,17,9,0,3,29
Marin,94920,139,158,0,16,313
Marin,94924,9,9,0,2,20
Marin,94925,86,50,0,13,149
Marin,94929,1,3,0,0,4
Marin,94930,17,29,0,7,53
Marin,94933,2,2,0,1,5
Marin,94937,5,12,0,1,18
Marin,94938,1,0,0,2,3
Marin,94939,110,46,0,18,174
Marin,94940,1,1,0,2,4
Marin,94941,260,236,0,49,545
Marin,94942,26,15,0,1,42
Marin,94945,80,36,0,5,121
Marin,94946,5,7,0,1,13
Marin,94947,45,49,0,8,102
Marin,94948,14,11,0,3,28
Marin,94949,114,54,0,6,174
Marin,94956,3,11,0,1,15
Marin,94957,22,37,0,3,62
Marin,94960,84,100,0,19,203
Marin,94963,3,3,0,2,8
Marin,94964,2,0,0,0,2
Marin,94965,141,84,0,25,250
Marin,94966,16,13,0,1,30
Marin,94970,6,6,0,4,16
Marin,94971,0,1,0,0,1
Marin,94973,4,6,0,4,14
Marin,94976,8,3,0,1,12
Marin,94977,6,1,0,0,7
Marin,94978,10,6,0,1,17
Marin,94979,12,2,0,3,17
Marin,94998,0,0,0,1,1
Mariposa,95306,1,1,0,0,2
Mariposa,95311,0,2,0,0,2
Mariposa,95318,0,1,0,0,1
Mariposa,95325,1,0,0,0,1
Mariposa,95338,13,9,1,1,24
Mariposa,95389,0,0,0,2,2
Mendocino,95410,0,4,0,0,4
Mendocino,95415,3,2,0,2,7
Mendocino,95418,1,0,0,0,1
Mendocino,95420,1,1,0,0,2
Mendocino,95428,0,1,0,0,1
Mendocino,95432,3,1,0,0,4
Mendocino,95437,25,22,0,2,49
Mendocino,95445,6,11,0,3,20
Mendocino,95449,2,0,0,0,2
Mendocino,95454,1,0,0,1,2
Mendocino,95456,3,8,0,0,11
Mendocino,95460,18,11,0,4,33
Mendocino,95463,0,1,0,0,1
Mendocino,95466,1,2,0,0,3
Mendocino,95468,2,0,0,1,3
Mendocino,95469,1,1,0,0,2
Mendocino,95470,3,9,0,0,12
Mendocino,95481,1,0,0,1,2
Mendocino,95482,99,35,7,7,148
Mendocino,95490,9,12,0,2,23
Mendocino,95494,4,2,0,0,6
Merced,93620,2,0,0,0,2
Merced,93635,11,2,0,0,13
Merced,95301,2,5,0,1,8
Merced,95303,0,1,0,0,1
Merced,95312,1,0,0,0,1
Merced,95315,2,0,0,0,2
Merced,95322,1,2,0,0,3
Merced,95324,1,0,0,0,1
Merced,95333,0,1,0,0,1
Merced,95334,3,1,0,0,4
Merced,95340,103,28,10,4,145
Merced,95341,2,1,0,0,3
Merced,95343,1,1,0,0,2
Merced,95344,7,2,0,1,10
Merced,95348,17,3,0,1,21
Merced,95369,1,0,0,0,1
Merced,95388,0,0,0,1,1
Modoc,96101,6,3,2,0,11
Mono,93517,2,0,0,1,3
Mono,93529,1,0,0,0,1
Mono,93541,2,0,0,0,2
Mono,93546,32,21,2,4,59
Mono,96107,0,1,0,0,1
Monterey,93426,1,0,0,0,1
Monterey,93901,246,26,13,8,293
Monterey,93902,28,11,1,3,43
Monterey,93905,13,3,0,1,17
Monterey,93906,27,10,0,2,39
Monterey,93907,11,12,0,2,25
Monterey,93908,25,28,0,3,56
Monterey,93912,9,1,0,1,11
Monterey,93920,3,8,0,0,11
Monterey,93921,26,37,0,7,70
Monterey,93922,11,15,0,1,27
Monterey,93923,62,78,0,5,145
Monterey,93924,32,33,0,5,70
Monterey,93926,3,0,0,0,3
Monterey,93927,1,0,0,0,1
Monterey,93930,2,1,0,0,3
Monterey,93933,15,11,0,1,27
Monterey,93940,201,47,2,9,259
Monterey,93942,42,8,0,1,51
Monterey,93943,1,1,0,0,2
Monterey,93944,1,0,0,0,1
Monterey,93950,49,46,0,7,102
Monterey,93953,17,39,0,4,60
Monterey,93955,19,10,0,6,35
Monterey,93960,1,0,0,0,1
Monterey,93962,1,2,0,0,3
Monterey,95004,3,4,0,0,7
Monterey,95012,2,0,0,0,2
Monterey,95039,0,4,0,0,4
Napa,94503,10,3,0,1,14
Napa,94508,4,0,0,2,6
Napa,94515,13,21,0,5,39
Napa,94558,122,95,0,15,232
Napa,94559,213,53,7,9,282
Napa,94562,2,1,0,0,3
Napa,94567,1,0,0,0,1
Napa,94573,2,1,0,0,3
Napa,94574,48,34,0,2,84
Napa,94581,16,13,0,0,29
Napa,94599,6,7,0,1,14
Nevada,95712,0,1,0,0,1
Nevada,95728,3,2,0,0,5
Nevada,95924,4,2,0,0,6
Nevada,95945,56,34,0,7,97
Nevada,95946,11,25,0,3,39
Nevada,95949,21,27,0,2,50
Nevada,95959,95,55,6,14,170
Nevada,95975,1,1,0,0,2
Nevada,96160,15,5,0,0,20
Nevada,96161,76,28,1,1,106
Nevada,96162,5,6,0,0,11
Orange,90620,27,4,0,2,33
Orange,90621,36,4,0,2,42
Orange,90622,2,4,0,0,6
Orange,90623,33,7,0,0,40
Orange,90630,104,25,0,4,133
Orange,90631,57,23,0,11,91
Orange,90632,9,3,0,0,12
Orange,90633,4,1,0,0,5
Orange,90680,8,1,0,0,9
Orange,90720,94,47,0,4,145
Orange,90740,145,64,0,17,226
Orange,90742,9,4,0,0,13
Orange,92602,119,35,0,2,156
Orange,92603,76,56,0,6,138
Orange,92604,72,48,0,11,131
Orange,92605,3,2,0,3,8
Orange,92606,227,22,0,6,255
Orange,92607,17,6,0,0,23
Orange,92609,9,4,0,0,13
Orange,92610,70,6,0,2,78
Orange,92613,0,2,1,0,3
Orange,92615,14,3,0,0,17
Orange,92616,19,4,0,1,24
Orange,92617,75,20,0,1,96
Orange,92619,41,8,0,1,50
Orange,92620,140,52,0,10,202
Orange,92621,0,1,0,3,4
Orange,92623,29,11,0,3,43
Orange,92624,24,9,0,2,35
Orange,92625,95,93,0,19,207
Orange,92627,87,35,0,15,137
Orange,92628,22,2,0,4,28
Orange,92629,135,82,0,6,223
Orange,92630,187,56,0,18,261
Orange,92631,1,5,0,0,6
Orange,92632,0,2,0,1,3
Orange,92633,0,3,0,2,5
Orange,92634,0,0,0,2,2
Orange,92635,1,2,0,3,6
Orange,92637,31,60,0,6,97
Orange,92640,0,1,0,0,1
Orange,92641,0,0,0,2,2
Orange,92643,0,1,0,0,1
Orange,92645,0,2,0,0,2
Orange,92646,64,65,1,9,139
Orange,92647,217,44,0,12,273
Orange,92648,165,79,0,15,259
Orange,92649,98,64,0,13,175
Orange,92650,0,0,0,1,1
Orange,92651,212,114,0,24,350
Orange,92652,21,7,0,5,33
Orange,92653,221,63,1,18,303
Orange,92654,10,4,0,1,15
Orange,92655,2,1,0,1,4
Orange,92656,269,34,0,10,313
Orange,92657,34,37,0,5,76
Orange,92658,92,39,0,7,138
Orange,92659,28,6,0,3,37
Orange,92661,16,19,0,2,37
Orange,92662,25,15,0,2,42
Orange,92663,133,63,0,18,214
Orange,92665,0,1,0,0,1
Orange,92666,2,1,0,0,3
Orange,92667,0,3,0,2,5
Orange,92668,2,0,0,5,7
Orange,92669,1,1,0,4,6
Orange,92670,0,2,0,1,3
Orange,92672,114,53,0,9,176
Orange,92673,116,48,0,8,172
Orange,92674,16,3,0,1,20
Orange,92675,153,57,0,14,224
Orange,92676,7,3,0,0,10
Orange,92677,244,133,0,21,398
Orange,92678,2,4,0,1,7
Orange,92679,55,47,0,14,116
Orange,92680,1,5,0,6,12
Orange,92683,122,19,21,5,167
Orange,92684,1,1,0,0,2
Orange,92685,10,3,0,0,13
Orange,92686,0,4,0,1,5
Orange,92687,0,1,0,0,1
Orange,92688,109,23,0,4,136
Orange,92690,18,4,0,1,23
Orange,92691,176,51,0,7,234
Orange,92692,86,71,0,9,166
Orange,92693,4,2,0,0,6
Orange,92694,127,35,0,7,169
Orange,92697,25,9,0,1,35
Orange,92702,76,12,20,3,111
Orange,92703,245,2,0,4,251
Orange,92704,49,8,0,4,61
Orange,92706,187,26,0,10,223
Orange,92707,221,15,0,5,241
Orange,92708,146,39,0,8,193
Orange,92711,23,3,0,1,27
Orange,92714,2,3,0,5,10
Orange,92715,1,9,0,2,12
Orange,92718,0,0,0,2,2
Orange,92720,0,1,0,4,5
Orange,92728,14,0,0,3,17
Orange,92780,434,45,0,9,488
Orange,92781,31,15,0,2,48
Orange,92782,60,31,0,6,97
Orange,92799,13,2,0,0,15
Orange,92801,40,6,0,11,57
Orange,92802,19,6,0,3,28
Orange,92803,8,1,0,0,9
Orange,92804,22,7,0,3,32
Orange,92805,76,11,0,9,96
Orange,92806,110,20,0,4,134
Orange,92807,90,42,0,14,146
Orange,92808,93,21,0,5,119
Orange,92809,14,7,0,0,21
Orange,92811,4,1,0,0,5
Orange,92814,0,4,0,0,4
Orange,92815,2,0,0,0,2
Orange,92816,3,1,0,0,4
Orange,92817,15,3,0,4,22
Orange,92821,205,20,0,9,234
Orange,92822,91,5,0,0,96
Orange,92823,3,4,0,0,7
Orange,92825,1,0,0,1,2
Orange,92831,71,20,0,5,96
Orange,92832,86,10,19,0,115
Orange,92833,28,26,0,3,57
Orange,92834,8,6,0,1,15
Orange,92835,131,30,0,3,164
Orange,92836,5,1,0,0,6
Orange,92837,8,2,0,0,10
Orange,92838,8,4,0,1,13
Orange,92840,43,5,0,2,50
Orange,92841,21,6,0,1,28
Orange,92842,11,0,0,0,11
Orange,92843,34,6,0,1,41
Orange,92844,8,1,0,1,10
Orange,92845,17,6,0,1,24
Orange,92846,1,3,0,0,4
Orange,92856,9,1,0,1,11
Orange,92857,1,1,0,0,2
Orange,92859,11,2,0,0,13
Orange,92861,21,24,0,1,46
Orange,92863,21,7,4,0,32
Orange,92865,29,11,0,2,42
Orange,92866,77,13,0,5,95
Orange,92867,110,36,0,5,151
Orange,92869,72,35,0,1,108
Orange,92870,61,26,0,8,95
Orange,92871,11,2,0,0,13
Orange,92885,9,6,0,2,17
Orange,92886,73,50,0,7,130
Orange,92887,45,18,0,1,64
Placer,95602,15,29,0,8,52
Placer,95603,131,51,4,8,194
Placer,95604,21,7,0,3,31
Placer,95631,4,2,0,1,7
Placer,95648,45,77,0,10,132
Placer,95650,33,15,0,2,50
Placer,95658,4,11,0,1,16
Placer,95661,410,51,2,14,477
Placer,95663,4,2,0,1,7
Placer,95677,53,20,0,4,77
Placer,95678,169,26,1,5,201
Placer,95681,1,0,0,0,1
Placer,95703,0,3,0,1,4
Placer,95704,1,0,0,0,1
Placer,95713,3,4,0,0,7
Placer,95714,1,3,0,0,4
Placer,95717,0,0,0,2,2
Placer,95722,11,10,0,1,22
Placer,95730,0,3,0,1,4
Placer,95736,0,1,0,0,1
Placer,95746,77,54,0,7,138
Placer,95747,61,61,0,6,128
Placer,95765,136,27,0,6,169
Placer,96140,4,2,0,0,6
Placer,96141,1,2,0,0,3
Placer,96142,0,1,0,0,1
Placer,96143,3,3,0,2,8
Placer,96145,18,8,0,1,27
Placer,96146,10,3,0,0,13
Placer,96148,2,1,0,0,3
Plumas,95923,0,1,0,0,1
Plumas,95947,1,1,0,0,2
Plumas,95971,21,6,2,3,32
Plumas,95983,0,1,0,0,1
Plumas,96020,3,0,0,2,5
Plumas,96103,7,3,0,0,10
Plumas,96105,0,1,0,1,2
Plumas,96106,3,0,0,1,4
Plumas,96122,4,2,0,0,6
Riverside,91719,0,1,0,0,1
Riverside,91752,11,1,0,2,14
Riverside,91760,0,1,0,0,1
Riverside,92201,129,29,11,4,173
Riverside,92202,10,3,0,1,14
Riverside,92203,26,27,0,3,56
Riverside,92210,70,25,0,5,100
Riverside,92211,115,92,1,6,214
Riverside,92220,28,22,0,5,55
Riverside,92223,25,20,0,7,52
Riverside,92225,5,0,0,2,7
Riverside,92226,2,0,0,1,3
Riverside,92234,30,24,0,5,59
Riverside,92235,3,1,0,0,4
Riverside,92236,5,1,0,0,6
Riverside,92239,1,0,0,0,1
Riverside,92240,6,12,0,2,20
Riverside,92241,0,4,0,2,6
Riverside,92247,3,10,0,0,13
Riverside,92248,10,5,0,0,15
Riverside,92253,67,85,0,10,162
Riverside,92254,2,0,0,0,2
Riverside,92255,11,7,0,3,21
Riverside,92258,1,1,0,0,2
Riverside,92260,112,79,0,11,202
Riverside,92261,8,5,0,1,14
Riverside,92262,127,61,0,6,194
Riverside,92263,22,16,0,3,41
Riverside,92264,53,56,0,14,123
Riverside,92270,131,84,0,13,228
Riverside,92274,2,2,0,0,4
Riverside,92276,0,4,0,1,5
Riverside,92282,1,0,0,0,1
Riverside,92313,9,4,0,2,15
Riverside,92320,3,2,0,0,5
Riverside,92330,1,0,0,0,1
Riverside,92331,1,0,0,0,1
Riverside,92337,1,2,0,0,3
Riverside,92343,0,1,0,1,2
Riverside,92344,2,0,0,0,2
Riverside,92362,0,1,0,0,1
Riverside,92370,0,0,0,1,1
Riverside,92388,0,0,0,1,1
Riverside,92500,0,1,0,0,1
Riverside,92502,58,5,0,1,64
Riverside,92503,45,11,3,2,61
Riverside,92504,49,13,0,5,67
Riverside,92505,35,10,0,3,48
Riverside,92506,160,71,0,5,236
Riverside,92507,182,21,1,8,212
Riverside,92508,23,15,0,5,43
Riverside,92509,20,5,0,5,30
Riverside,92513,6,1,0,0,7
Riverside,92514,1,0,0,1,2
Riverside,92516,16,2,0,0,18
Riverside,92517,4,5,0,4,13
Riverside,92518,15,3,0,0,18
Riverside,92519,3,1,0,0,4
Riverside,92521,6,2,0,0,8
Riverside,92522,3,0,0,0,3
Riverside,92530,8,4,0,1,13
Riverside,92531,5,2,0,0,7
Riverside,92532,7,5,0,0,12
Riverside,92536,2,1,0,0,3
Riverside,92539,1,3,0,0,4
Riverside,92543,24,5,0,4,33
Riverside,92544,14,10,0,2,26
Riverside,92545,4,9,0,2,15
Riverside,92546,1,0,0,0,1
Riverside,92548,0,1,0,0,1
Riverside,92549,9,10,0,1,20
Riverside,92551,3,0,0,1,4
Riverside,92552,9,1,0,1,11
Riverside,92553,13,5,1,2,21
Riverside,92555,6,7,0,0,13
Riverside,92556,1,0,0,0,1
Riverside,92557,6,4,0,4,14
Riverside,92561,1,1,0,2,4
Riverside,92562,95,41,0,7,143
Riverside,92563,144,14,11,4,173
Riverside,92564,6,1,0,1,8
Riverside,92570,6,2,0,1,9
Riverside,92571,3,0,0,0,3
Riverside,92572,2,0,0,0,2
Riverside,92581,2,2,0,1,5
Riverside,92582,2,1,0,0,3
Riverside,92583,2,4,0,2,8
Riverside,92584,15,13,0,2,30
Riverside,92585,1,5,0,1,7
Riverside,92586,16,7,0,0,23
Riverside,92587,16,9,0,1,26
Riverside,92589,18,2,0,0,20
Riverside,92590,139,7,0,3,149
Riverside,92591,37,13,0,2,52
Riverside,92592,43,22,0,6,71
Riverside,92593,11,1,0,0,12
Riverside,92595,15,8,0,0,23
Riverside,92596,10,6,0,3,19
Riverside,92860,19,15,0,3,37
Riverside,92877,9,4,0,0,13
Riverside,92878,23,0,0,0,23
Riverside,92879,72,3,0,2,77
Riverside,92880,32,5,0,2,39
Riverside,92881,33,7,0,1,41
Riverside,92882,28,13,0,5,46
Riverside,92883,38,10,0,4,52
Sacramento,94229,15,0,0,1,16
Sacramento,94232,9,0,0,0,9
Sacramento,94234,0,0,0,1,1
Sacramento,94236,2,2,0,0,4
Sacramento,94237,1,0,0,0,1
Sacramento,94240,0,0,0,1,1
Sacramento,94244,100,3,0,2,105
Sacramento,94249,9,2,0,0,11
Sacramento,94252,9,0,0,0,9
Sacramento,94279,35,0,0,0,35
Sacramento,94280,8,1,0,0,9
Sacramento,94283,12,0,0,0,12
Sacramento,94287,1,0,0,0,1
Sacramento,94296,3,0,0,0,3
Sacramento,94298,5,0,0,0,5
Sacramento,95608,96,150,0,16,262
Sacramento,95609,18,9,0,1,28
Sacramento,95610,35,16,0,7,58
Sacramento,95611,5,1,0,2,8
Sacramento,95615,2,2,0,0,4
Sacramento,95621,16,19,0,6,41
Sacramento,95624,70,35,0,4,109
Sacramento,95626,6,2,0,0,8
Sacramento,95628,92,112,0,14,218
Sacramento,95630,245,81,0,12,338
Sacramento,95632,9,5,0,0,14
Sacramento,95638,2,3,0,0,5
Sacramento,95639,1,0,0,0,1
Sacramento,95641,2,2,0,0,4
Sacramento,95652,15,0,0,0,15
Sacramento,95655,29,5,0,0,34
Sacramento,95660,2,1,0,2,5
Sacramento,95662,25,26,0,10,61
Sacramento,95670,224,75,0,10,309
Sacramento,95673,3,3,0,3,9
Sacramento,95683,12,23,0,3,38
Sacramento,95690,1,7,0,0,8
Sacramento,95693,11,4,0,0,15
Sacramento,95741,98,1,0,0,99
Sacramento,95742,17,7,0,0,24
Sacramento,95757,21,23,0,0,44
Sacramento,95758,110,49,0,7,166
Sacramento,95759,18,3,0,1,22
Sacramento,95762,1,8,0,4,13
Sacramento,95763,23,5,0,4,32
Sacramento,95811,359,18,0,5,382
Sacramento,95812,103,12,1,7,123
Sacramento,95813,8,0,0,1,9
Sacramento,95815,230,16,0,5,251
Sacramento,95816,275,73,0,9,357
Sacramento,95817,66,23,0,4,93
Sacramento,95818,164,160,0,19,343
Sacramento,95819,89,71,0,16,176
Sacramento,95820,10,14,0,3,27
Sacramento,95821,64,35,0,7,106
Sacramento,95822,83,106,0,11,200
Sacramento,95823,14,10,0,2,26
Sacramento,95824,10,3,0,1,14
Sacramento,95826,182,30,3,12,227
Sacramento,95827,132,15,0,11,158
Sacramento,95828,8,5,0,3,16
Sacramento,95829,23,7,0,2,32
Sacramento,95830,1,1,0,0,2
Sacramento,95831,91,151,0,18,260
Sacramento,95832,2,1,0,0,3
Sacramento,95833,484,34,0,7,525
Sacramento,95834,182,24,0,8,214
Sacramento,95835,29,36,0,8,73
Sacramento,95837,1,8,0,0,9
Sacramento,95838,5,4,0,1,10
Sacramento,95841,19,18,0,3,40
Sacramento,95842,8,4,0,3,15
Sacramento,95843,7,7,0,1,15
Sacramento,95851,11,1,0,1,13
Sacramento,95852,4,0,0,0,4
Sacramento,95853,4,1,0,0,5
Sacramento,95860,3,4,0,0,7
Sacramento,95864,157,143,0,15,315
Sacramento,95865,15,4,0,3,22
Sacramento,95866,7,1,0,1,9
Sacramento,95899,43,1,0,0,44
Sacramento,96557,1,0,0,0,1
San Benito,95023,44,9,3,4,60
San Benito,95024,1,3,0,0,4
San Benito,95045,4,4,0,1,9
San Benito,95075,2,1,0,0,3
San Bernardino,91701,35,18,0,4,57
San Bernardino,91708,7,4,0,1,12
San Bernardino,91709,85,33,0,6,124
San Bernardino,91710,50,5,0,5,60
San Bernardino,91729,16,9,0,0,25
San Bernardino,91730,373,21,10,8,412
San Bernardino,91737,13,8,0,4,25
San Bernardino,91739,21,9,0,3,33
San Bernardino,91761,109,7,0,3,119
San Bernardino,91762,28,5,0,3,36
San Bernardino,91763,17,1,0,1,19
San Bernardino,91764,208,8,1,3,220
San Bernardino,91784,31,23,0,3,57
San Bernardino,91785,11,0,0,2,13
San Bernardino,91786,144,23,0,4,171
San Bernardino,92242,1,1,0,0,2
San Bernardino,92252,15,8,3,2,28
San Bernardino,92256,1,1,0,0,2
San Bernardino,92267,0,2,0,0,2
San Bernardino,92268,0,2,0,0,2
San Bernardino,92277,6,1,0,0,7
San Bernardino,92278,0,1,0,0,1
San Bernardino,92284,13,9,0,5,27
San Bernardino,92285,2,1,0,0,3
San Bernardino,92286,1,2,0,0,3
San Bernardino,92301,14,0,0,0,14
San Bernardino,92305,0,1,0,0,1
San Bernardino,92307,15,11,0,0,26
San Bernardino,92308,13,12,0,6,31
San Bernardino,92310,7,1,0,0,8
San Bernardino,92311,5,2,0,1,8
San Bernardino,92312,1,1,0,0,2
San Bernardino,92314,6,7,0,2,15
San Bernardino,92315,17,9,0,2,28
San Bernardino,92316,4,2,0,0,6
San Bernardino,92317,7,12,0,3,22
San Bernardino,92321,2,1,0,1,4
San Bernardino,92322,0,2,0,0,2
San Bernardino,92324,14,5,0,3,22
San Bernardino,92325,10,10,0,1,21
San Bernardino,92329,0,1,0,0,1
San Bernardino,92333,0,3,0,0,3
San Bernardino,92334,3,0,0,0,3
San Bernardino,92335,7,4,15,1,27
San Bernardino,92336,14,4,0,0,18
San Bernardino,92339,0,1,0,1,2
San Bernardino,92340,2,0,0,1,3
San Bernardino,92342,2,1,0,0,3
San Bernardino,92344,0,1,0,0,1
San Bernardino,92345,7,6,0,2,15
San Bernardino,92346,27,14,0,1,42
San Bernardino,92350,2,0,0,0,2
San Bernardino,92352,17,3,0,4,24
San Bernardino,92354,21,8,0,3,32
San Bernardino,92356,4,0,0,1,5
San Bernardino,92357,0,1,0,0,1
San Bernardino,92359,3,1,0,3,7
San Bernardino,92363,5,0,0,0,5
San Bernardino,92365,0,0,0,1,1
San Bernardino,92369,1,0,0,0,1
San Bernardino,92371,1,0,0,0,1
San Bernardino,92372,0,1,0,0,1
San Bernardino,92373,123,52,1,10,186
San Bernardino,92374,56,15,0,4,75
San Bernardino,92375,20,4,0,3,27
San Bernardino,92376,8,1,0,0,9
San Bernardino,92377,6,1,0,1,8
San Bernardino,92382,5,10,0,1,16
San Bernardino,92385,1,0,0,0,1
San Bernardino,92386,1,1,0,0,2
San Bernardino,92391,3,3,0,0,6
San Bernardino,92392,95,10,12,10,127
San Bernardino,92393,4,3,0,3,10
San Bernardino,92394,2,1,0,1,4
San Bernardino,92395,15,11,0,1,27
San Bernardino,92397,6,9,0,1,16
San Bernardino,92399,23,24,0,5,52
San Bernardino,92401,94,7,0,3,104
San Bernardino,92402,7,0,0,1,8
San Bernardino,92404,3,7,0,1,11
San Bernardino,92405,4,3,0,1,8
San Bernardino,92406,2,1,0,0,3
San Bernardino,92407,10,5,0,1,16
San Bernardino,92408,160,4,1,3,168
San Bernardino,92410,12,1,0,1,14
San Bernardino,92411,0,0,0,1,1
San Bernardino,92413,1,1,0,0,2
San Bernardino,92415,274,8,35,3,320
San Bernardino,92418,0,1,0,0,1
San Bernardino,92423,18,3,0,3,24
San Bernardino,92427,4,2,0,0,6
San Diego,91901,24,7,0,3,34
San Diego,91902,34,29,0,2,65
San Diego,91903,7,5,0,1,13
San Diego,91905,0,1,0,0,1
San Diego,91906,2,0,0,0,2
San Diego,91908,5,5,0,2,12
San Diego,91910,187,27,2,14,230
San Diego,91911,16,7,0,5,28
San Diego,91912,7,4,0,2,13
San Diego,91913,16,11,0,1,28
San Diego,91914,28,5,0,0,33
San Diego,91915,16,10,0,4,30
San Diego,91916,0,1,0,1,2
San Diego,91917,0,1,0,0,1
San Diego,91921,13,4,0,2,19
San Diego,91932,9,6,0,3,18
San Diego,91933,1,1,0,0,2
San Diego,91935,11,12,0,2,25
San Diego,91941,55,60,0,15,130
San Diego,91942,126,43,0,4,173
San Diego,91943,10,2,0,0,12
San Diego,91944,7,10,0,2,19
San Diego,91945,8,9,0,0,17
San Diego,91946,2,1,0,1,4
San Diego,91948,0,1,0,0,1
San Diego,91950,17,7,0,3,27
San Diego,91951,0,0,0,1,1
San Diego,91962,3,1,0,2,6
San Diego,91976,4,2,0,0,6
San Diego,91977,12,16,0,4,32
San Diego,91978,4,7,0,2,13
San Diego,91979,2,1,0,0,3
San Diego,92001,0,1,0,0,1
San Diego,92003,23,12,0,0,35
San Diego,92004,5,6,0,0,11
San Diego,92006,0,0,0,1,1
San Diego,92007,70,38,0,3,111
San Diego,92008,387,53,0,17,457
San Diego,92009,161,95,0,16,272
San Diego,92010,84,17,0,6,107
San Diego,92011,142,55,0,7,204
San Diego,92013,18,6,0,1,25
San Diego,92014,150,108,0,20,278
San Diego,92018,20,4,0,0,24
San Diego,92019,38,31,0,10,79
San Diego,92020,126,40,1,14,181
San Diego,92021,25,9,0,7,41
San Diego,92022,5,3,0,1,9
San Diego,92023,30,16,0,3,49
San Diego,92024,284,138,0,32,454
San Diego,92025,154,45,0,10,209
San Diego,92026,26,30,0,10,66
San Diego,92027,22,15,0,2,39
San Diego,92028,43,52,0,8,103
San Diego,92029,29,28,0,2,59
San Diego,92030,4,1,0,1,6
San Diego,92032,0,0,0,2,2
San Diego,92033,6,3,0,0,9
San Diego,92035,0,1,0,0,1
San Diego,92036,9,7,0,3,19
San Diego,92038,38,16,0,6,60
San Diego,92039,10,4,0,1,15
San Diego,92040,21,10,0,4,35
San Diego,92041,1,2,0,2,5
San Diego,92042,0,2,0,0,2
San Diego,92046,6,1,0,0,7
San Diego,92049,7,4,0,2,13
San Diego,92050,0,0,0,1,1
San Diego,92051,2,2,0,1,5
San Diego,92052,13,1,0,0,14
San Diego,92054,92,27,0,12,131
San Diego,92055,14,0,0,0,14
San Diego,92056,56,49,0,12,117
San Diego,92057,34,31,0,7,72
San Diego,92058,10,6,0,2,18
San Diego,92059,1,0,0,0,1
San Diego,92060,2,0,0,0,2
San Diego,92061,3,2,0,2,7
San Diego,92064,98,61,0,11,170
San Diego,92065,27,27,0,5,59
San Diego,92066,0,1,0,0,1
San Diego,92067,167,95,0,18,280
San Diego,92068,2,1,0,0,3
San Diego,92069,38,24,0,13,75
San Diego,92070,1,1,0,0,2
San Diego,92071,20,22,0,10,52
San Diego,92072,2,2,0,2,6
San Diego,92074,8,3,0,2,13
San Diego,92075,221,59,0,11,291
San Diego,92077,0,2,0,0,2
San Diego,92078,101,45,0,4,150
San Diego,92079,5,2,0,2,9
San Diego,92081,179,29,3,4,215
San Diego,92082,21,16,0,3,40
San Diego,92083,23,7,0,7,37
San Diego,92084,54,31,0,3,88
San Diego,92085,16,12,0,0,28
San Diego,92086,1,0,0,1,2
San Diego,92088,15,1,0,3,19
San Diego,92091,22,6,0,1,29
San Diego,92093,26,12,0,0,38
San Diego,92096,3,1,0,0,4
San Diego,92102,58,13,0,10,81
San Diego,92103,404,158,0,43,605
San Diego,92104,93,43,0,15,151
San Diego,92105,18,7,0,1,26
San Diego,92106,185,111,0,22,318
San Diego,92107,95,54,0,16,165
San Diego,92109,153,91,0,28,272
San Diego,92110,281,61,0,21,363
San Diego,92111,119,44,0,14,177
San Diego,92112,101,30,113,14,258
San Diego,92113,8,1,0,1,10
San Diego,92114,41,7,0,4,52
San Diego,92115,39,41,0,5,85
San Diego,92116,87,38,0,13,138
San Diego,92117,128,43,0,16,187
San Diego,92118,75,103,0,15,193
San Diego,92119,44,25,0,8,77
San Diego,92120,68,51,0,13,132
San Diego,92122,304,79,0,19,402
San Diego,92123,349,32,0,11,392
San Diego,92124,43,45,0,9,97
San Diego,92126,70,23,0,13,106
San Diego,92127,251,61,0,7,319
San Diego,92128,146,88,0,18,252
San Diego,92129,107,52,0,16,175
San Diego,92131,263,76,0,19,358
San Diego,92132,16,0,0,0,16
San Diego,92134,1,0,0,0,1
San Diego,92135,3,0,0,0,3
San Diego,92136,17,1,0,0,18
San Diego,92137,5,2,0,0,7
San Diego,92138,22,10,1,4,37
San Diego,92139,1,3,0,1,5
San Diego,92140,2,1,0,0,3
San Diego,92142,10,4,0,0,14
San Diego,92143,7,6,0,3,16
San Diego,92145,1,1,0,0,2
San Diego,92147,3,2,0,0,5
San Diego,92149,1,1,0,0,2
San Diego,92150,24,8,0,2,34
San Diego,92152,4,1,0,0,5
San Diego,92153,4,1,0,0,5
San Diego,92154,22,5,0,4,31
San Diego,92155,2,0,0,0,2
San Diego,92159,12,5,0,2,19
San Diego,92160,8,7,0,2,17
San Diego,92163,28,9,0,4,41
San Diego,92165,1,0,0,0,1
San Diego,92166,23,13,0,0,36
San Diego,92167,7,5,0,1,13
San Diego,92168,13,2,0,1,16
San Diego,92169,25,21,0,6,52
San Diego,92170,1,0,0,0,1
San Diego,92171,5,3,0,0,8
San Diego,92172,24,3,0,0,27
San Diego,92173,10,4,0,3,17
San Diego,92174,2,1,0,0,3
San Diego,92175,8,1,0,0,9
San Diego,92176,16,4,0,1,21
San Diego,92177,5,2,0,0,7
San Diego,92178,18,18,0,2,38
San Diego,92182,4,3,0,1,8
San Diego,92186,37,0,1,3,41
San Diego,92191,13,4,0,0,17
San Diego,92192,33,8,0,0,41
San Diego,92193,6,5,0,0,11
San Diego,92195,8,1,0,0,9
San Diego,92196,5,6,0,0,11
San Diego,92197,3,0,0,0,3
San Diego,92198,15,9,0,1,25
San Francisco,94101,3,0,0,2,5
San Francisco,94108,422,37,0,17,476
San Francisco,94109,348,162,0,47,557
San Francisco,94110,227,102,0,36,365
San Francisco,94112,70,47,0,12,129
San Francisco,94114,244,188,1,63,496
San Francisco,94115,211,122,0,42,375
San Francisco,94116,106,106,0,14,226
San Francisco,94117,239,145,0,47,431
San Francisco,94118,222,209,0,40,471
San Francisco,94119,35,7,1,1,44
San Francisco,94120,33,3,2,4,42
San Francisco,94121,164,106,0,19,289
San Francisco,94122,139,105,0,22,266
San Francisco,94123,201,115,0,42,358
San Francisco,94124,34,9,0,2,45
San Francisco,94126,76,13,0,2,91
San Francisco,94127,190,141,0,21,352
San Francisco,94129,100,16,0,8,124
San Francisco,94130,2,1,0,1,4
San Francisco,94131,143,114,0,24,281
San Francisco,94132,55,38,0,5,98
San Francisco,94133,287,68,0,27,382
San Francisco,94134,14,9,0,2,25
San Francisco,94140,7,1,0,1,9
San Francisco,94141,9,1,0,1,11
San Francisco,94142,21,6,0,3,30
San Francisco,94143,20,4,0,1,25
San Francisco,94146,11,10,0,1,22
San Francisco,94147,18,14,0,3,35
San Francisco,94150,1,0,0,0,1
San Francisco,94158,163,8,0,0,171
San Francisco,94159,20,5,0,2,27
San Francisco,94163,0,0,0,1,1
San Francisco,94164,13,5,0,2,20
San Francisco,94172,7,0,0,0,7
San Francisco,94177,2,1,0,0,3
San Francisco,94188,13,1,0,1,15
San Joaquin,95201,61,4,2,3,70
San Joaquin,95202,211,15,29,1,256
San Joaquin,95203,6,7,0,2,15
San Joaquin,95204,20,20,0,4,44
San Joaquin,95205,5,0,0,0,5
San Joaquin,95206,4,0,0,0,4
San Joaquin,95207,115,28,0,8,151
San Joaquin,95208,2,1,0,0,3
San Joaquin,95209,11,15,0,6,32
San Joaquin,95210,1,1,0,1,3
San Joaquin,95211,2,0,0,0,2
San Joaquin,95212,6,8,0,2,16
San Joaquin,95213,2,0,0,2,4
San Joaquin,95215,6,3,0,0,9
San Joaquin,95219,137,32,0,4,173
San Joaquin,95220,4,5,0,0,9
San Joaquin,95227,1,2,0,0,3
San Joaquin,95231,3,1,1,0,5
San Joaquin,95236,2,0,0,0,2
San Joaquin,95237,0,2,0,0,2
San Joaquin,95240,25,17,0,2,44
San Joaquin,95241,11,6,0,1,18
San Joaquin,95242,21,18,0,1,40
San Joaquin,95253,1,0,0,0,1
San Joaquin,95258,13,6,0,1,20
San Joaquin,95267,8,6,0,0,14
San Joaquin,95269,5,3,0,0,8
San Joaquin,95296,1,0,0,1,2
San Joaquin,95304,3,2,0,0,5
San Joaquin,95320,3,3,0,0,6
San Joaquin,95330,1,1,0,1,3
San Joaquin,95336,16,9,0,1,26
San Joaquin,95337,13,2,0,0,15
San Joaquin,95366,18,4,0,1,23
San Joaquin,95376,24,4,0,2,30
San Joaquin,95377,11,1,0,2,14
San Joaquin,95378,4,3,0,0,7
San Joaquin,95391,1,2,0,1,4
San Joaquin,95686,1,0,0,0,1
San Luis Obispo,93401,270,41,1,16,328
San Luis Obispo,93402,15,21,0,5,41
San Luis Obispo,93403,19,5,0,0,24
San Luis Obispo,93405,19,32,0,3,54
San Luis Obispo,93406,31,11,0,3,45
San Luis Obispo,93407,4,0,0,0,4
San Luis Obispo,93408,60,1,9,0,70
San Luis Obispo,93412,5,4,0,0,9
San Luis Obispo,93420,40,59,0,3,102
San Luis Obispo,93421,14,5,0,2,21
San Luis Obispo,93422,36,25,0,9,70
San Luis Obispo,93423,6,6,0,0,12
San Luis Obispo,93424,6,7,0,0,13
San Luis Obispo,93428,17,33,0,2,52
San Luis Obispo,93430,12,6,0,0,18
San Luis Obispo,93432,3,4,0,0,7
San Luis Obispo,93433,8,3,0,4,15
San Luis Obispo,93435,0,1,0,0,1
San Luis Obispo,93442,14,19,0,7,40
San Luis Obispo,93443,8,6,0,0,14
San Luis Obispo,93444,25,42,1,1,69
San Luis Obispo,93445,1,1,0,1,3
San Luis Obispo,93446,39,35,0,4,78
San Luis Obispo,93447,4,5,0,2,11
San Luis Obispo,93448,24,8,0,0,32
San Luis Obispo,93449,21,15,0,2,38
San Luis Obispo,93451,2,2,0,0,4
San Luis Obispo,93452,2,1,0,0,3
San Luis Obispo,93453,2,4,0,2,8
San Luis Obispo,93461,1,1,0,0,2
San Luis Obispo,93465,17,7,0,2,26
San Luis Obispo,93475,1,2,1,0,4
San Luis Obispo,93483,7,3,0,2,12
San Mateo,94002,127,46,0,20,193
San Mateo,94005,28,5,0,0,33
San Mateo,94010,395,172,1,31,599
San Mateo,94011,29,13,0,1,43
San Mateo,94014,37,3,0,5,45
San Mateo,94015,52,20,0,3,75
San Mateo,94016,1,0,0,0,1
San Mateo,94017,7,0,0,0,7
San Mateo,94018,10,14,0,2,26
San Mateo,94019,57,37,0,2,96
San Mateo,94020,3,0,0,0,3
San Mateo,94021,0,1,0,0,1
San Mateo,94026,34,16,0,3,53
San Mateo,94027,52,80,0,9,141
San Mateo,94028,62,55,0,6,123
San Mateo,94030,68,29,0,4,101
San Mateo,94037,13,4,0,0,17
San Mateo,94038,5,7,0,1,13
San Mateo,94044,65,41,0,13,119
San Mateo,94060,4,3,0,0,7
San Mateo,94061,81,47,0,13,141
San Mateo,94062,105,91,0,21,217
San Mateo,94064,5,5,0,1,11
San Mateo,94065,395,40,0,7,442
San Mateo,94066,77,21,0,4,102
San Mateo,94070,229,102,0,14,345
San Mateo,94074,0,1,0,0,1
San Mateo,94080,348,33,2,10,393
San Mateo,94083,8,3,0,0,11
San Mateo,94128,22,3,0,1,26
San Mateo,94401,94,36,0,14,144
San Mateo,94402,337,99,1,17,454
San Mateo,94403,215,67,0,6,288
San Mateo,94404,277,56,0,13,346
Santa Barbara,93013,29,15,0,5,49
Santa Barbara,93014,5,2,0,0,7
Santa Barbara,93067,8,12,0,2,22
Santa Barbara,93102,30,7,0,3,40
Santa Barbara,93103,30,44,0,7,81
Santa Barbara,93105,89,84,0,11,184
Santa Barbara,93106,3,6,0,0,9
Santa Barbara,93108,67,79,0,16,162
Santa Barbara,93109,26,34,0,7,67
Santa Barbara,93110,28,35,0,11,74
Santa Barbara,93111,45,30,0,4,79
Santa Barbara,93116,6,5,0,0,11
Santa Barbara,93117,68,41,0,9,118
Santa Barbara,93118,2,1,0,0,3
Santa Barbara,93120,7,1,0,3,11
Santa Barbara,93121,8,0,0,1,9
Santa Barbara,93130,13,10,0,1,24
Santa Barbara,93140,8,2,0,1,11
Santa Barbara,93150,23,18,0,2,43
Santa Barbara,93160,2,4,0,0,6
Santa Barbara,93190,10,5,0,1,16
Santa Barbara,93427,4,4,0,1,9
Santa Barbara,93434,2,0,0,0,2
Santa Barbara,93436,29,7,0,4,40
Santa Barbara,93437,3,0,0,0,3
Santa Barbara,93438,1,4,0,1,6
Santa Barbara,93440,3,2,0,0,5
Santa Barbara,93441,15,7,0,1,23
Santa Barbara,93454,123,11,5,2,141
Santa Barbara,93455,37,25,0,6,68
Santa Barbara,93456,10,1,0,0,11
Santa Barbara,93457,6,4,0,0,10
Santa Barbara,93458,6,2,0,2,10
Santa Barbara,93460,18,11,1,5,35
Santa Barbara,93463,21,27,0,3,51
Santa Barbara,93464,9,2,0,0,11
Santa Clara,94022,188,120,1,27,336
Santa Clara,94023,23,18,0,5,46
Santa Clara,94024,114,89,0,10,213
Santa Clara,94035,10,1,0,1,12
Santa Clara,94039,33,4,0,0,37
Santa Clara,94040,153,39,0,12,204
Santa Clara,94041,286,21,0,7,314
Santa Clara,94042,9,4,0,0,13
Santa Clara,94043,441,36,0,12,489
Santa Clara,94085,75,7,0,4,86
Santa Clara,94086,127,23,0,4,154
Santa Clara,94087,67,54,0,9,130
Santa Clara,94088,4,3,0,1,8
Santa Clara,94089,92,2,0,9,103
Santa Clara,94301,402,116,1,28,547
Santa Clara,94302,25,6,0,4,35
Santa Clara,94303,378,79,0,21,478
Santa Clara,94305,93,39,0,4,136
Santa Clara,94306,423,109,2,36,570
Santa Clara,94309,14,2,0,2,18
Santa Clara,95002,30,1,0,2,33
Santa Clara,95008,197,25,0,8,230
Santa Clara,95009,3,0,0,1,4
Santa Clara,95011,7,2,0,1,10
Santa Clara,95014,338,50,0,14,402
Santa Clara,95015,15,3,0,0,18
Santa Clara,95020,31,16,0,5,52
Santa Clara,95021,8,4,0,0,12
Santa Clara,95030,131,57,0,11,199
Santa Clara,95031,23,15,0,2,40
Santa Clara,95032,148,66,0,11,225
Santa Clara,95033,20,9,0,1,30
Santa Clara,95035,81,10,0,4,95
Santa Clara,95036,4,0,0,0,4
Santa Clara,95037,65,33,0,8,106
Santa Clara,95038,14,5,0,1,20
Santa Clara,95044,3,2,0,0,5
Santa Clara,95046,4,2,0,0,6
Santa Clara,95050,131,21,0,5,157
Santa Clara,95051,114,26,0,7,147
Santa Clara,95052,18,2,0,1,21
Santa Clara,95053,34,12,0,2,48
Santa Clara,95054,330,17,0,4,351
Santa Clara,95055,9,1,0,0,10
Santa Clara,95056,2,0,0,1,3
Santa Clara,95070,130,107,0,19,256
Santa Clara,95071,6,4,0,0,10
Santa Clara,95101,1,0,0,0,1
Santa Clara,95103,5,1,0,0,6
Santa Clara,95106,1,0,0,1,2
Santa Clara,95108,3,0,0,0,3
Santa Clara,95109,17,5,0,1,23
Santa Clara,95111,14,1,0,1,16
Santa Clara,95112,307,28,0,11,346
Santa Clara,95116,6,1,0,0,7
Santa Clara,95117,26,9,0,2,37
Santa Clara,95118,36,18,1,4,59
Santa Clara,95119,48,1,0,2,51
Santa Clara,95120,50,53,0,7,110
Santa Clara,95121,15,3,0,3,21
Santa Clara,95122,14,2,0,1,17
Santa Clara,95123,40,12,0,8,60
Santa Clara,95124,70,40,0,8,118
Santa Clara,95125,198,92,0,19,309
Santa Clara,95126,384,47,0,8,439
Santa Clara,95127,17,12,1,3,33
Santa Clara,95128,113,29,0,5,147
Santa Clara,95129,37,18,0,8,63
Santa Clara,95130,6,3,0,3,12
Santa Clara,95131,167,14,1,9,191
Santa Clara,95132,19,12,0,0,31
Santa Clara,95133,10,2,0,1,13
Santa Clara,95134,254,9,0,7,270
Santa Clara,95135,16,30,0,7,53
Santa Clara,95136,24,12,0,6,42
Santa Clara,95138,34,17,0,1,52
Santa Clara,95139,2,2,0,1,5
Santa Clara,95140,2,1,0,1,4
Santa Clara,95148,17,7,0,4,28
Santa Clara,95150,21,7,0,2,30
Santa Clara,95151,2,0,0,1,3
Santa Clara,95152,4,1,0,0,5
Santa Clara,95153,11,3,0,1,15
Santa Clara,95154,12,6,0,1,19
Santa Clara,95155,11,4,0,0,15
Santa Clara,95157,10,0,0,1,11
Santa Clara,95158,8,2,0,0,10
Santa Clara,95159,9,3,0,1,13
Santa Clara,95160,9,9,0,1,19
Santa Clara,95161,12,2,0,0,14
Santa Clara,95164,3,0,0,1,4
Santa Clara,95170,4,2,0,0,6
Santa Clara,95172,2,0,0,1,3
Santa Clara,95173,1,3,0,0,4
Santa Clara,95192,4,1,0,0,5
Santa Cruz,95001,22,14,0,0,36
Santa Cruz,95003,69,54,0,8,131
Santa Cruz,95005,10,5,0,2,17
Santa Cruz,95006,7,7,0,2,16
Santa Cruz,95007,0,2,0,0,2
Santa Cruz,95010,33,23,0,5,61
Santa Cruz,95017,0,2,0,0,2
Santa Cruz,95018,6,9,0,1,16
Santa Cruz,95019,1,2,0,1,4
Santa Cruz,95041,0,1,0,0,1
Santa Cruz,95060,293,105,10,18,426
Santa Cruz,95061,18,11,1,5,35
Santa Cruz,95062,83,49,0,11,143
Santa Cruz,95063,22,11,0,0,33
Santa Cruz,95064,7,4,0,0,11
Santa Cruz,95065,10,15,0,3,28
Santa Cruz,95066,34,19,0,3,56
Santa Cruz,95067,6,8,0,1,15
Santa Cruz,95073,44,17,0,8,69
Santa Cruz,95076,81,25,1,8,115
Santa Cruz,95077,2,2,0,0,4
Shasta,96001,190,36,10,19,255
Shasta,96002,32,15,0,4,51
Shasta,96003,19,24,0,3,46
Shasta,96007,1,5,0,0,6
Shasta,96013,1,0,0,0,1
Shasta,96019,2,4,0,2,8
Shasta,96022,3,6,0,0,9
Shasta,96028,1,1,0,0,2
Shasta,96033,0,1,0,0,1
Shasta,96047,0,2,0,0,2
Shasta,96049,11,2,0,3,16
Shasta,96051,2,2,0,0,4
Shasta,96056,1,1,0,0,2
Shasta,96062,1,1,0,0,2
Shasta,96065,0,1,0,0,1
Shasta,96069,1,0,0,0,1
Shasta,96073,16,3,0,0,19
Shasta,96087,0,2,0,1,3
Shasta,96088,4,7,0,0,11
Shasta,96089,0,1,0,0,1
Shasta,96096,1,2,0,0,3
Shasta,96099,23,14,0,2,39
Sierra,95910,1,0,0,0,1
Sierra,95936,2,1,1,0,4
Sierra,96118,0,0,0,1,1
Sierra,96124,1,0,0,0,1
Sierra,96125,1,0,0,0,1
Sierra,96126,1,0,0,0,1
Siskiyou,96014,2,0,0,0,2
Siskiyou,96025,1,1,0,0,2
Siskiyou,96027,1,3,0,0,4
Siskiyou,96032,1,0,0,0,1
Siskiyou,96034,0,1,0,0,1
Siskiyou,96037,1,0,0,0,1
Siskiyou,96038,0,1,0,0,1
Siskiyou,96044,3,1,0,0,4
Siskiyou,96050,0,2,0,1,3
Siskiyou,96057,0,2,0,0,2
Siskiyou,96064,1,2,0,0,3
Siskiyou,96067,15,12,0,0,27
Siskiyou,96094,6,2,0,0,8
Siskiyou,96097,35,10,4,1,50
Solano,94510,88,37,0,9,134
Solano,94533,202,29,20,5,256
Solano,94534,53,32,0,4,89
Solano,94535,4,0,0,0,4
Solano,94571,12,18,0,1,31
Solano,94585,18,4,0,5,27
Solano,94589,4,3,0,3,10
Solano,94590,86,20,2,9,117
Solano,94591,17,21,0,3,41
Solano,94592,1,1,0,0,2
Solano,95620,9,5,1,1,16
Solano,95687,19,17,0,1,37
Solano,95688,32,22,0,5,59
Solano,95696,11,3,0,2,16
Sonoma,94922,3,0,0,0,3
Sonoma,94923,7,18,0,1,26
Sonoma,94927,5,2,0,0,7
Sonoma,94928,27,16,0,3,46
Sonoma,94931,18,9,0,0,27
Sonoma,94951,3,8,0,1,12
Sonoma,94952,104,56,0,5,165
Sonoma,94953,10,4,0,0,14
Sonoma,94954,73,29,0,10,112
Sonoma,94955,3,0,0,0,3
Sonoma,94972,0,1,0,0,1
Sonoma,94975,6,0,0,0,6
Sonoma,95401,188,23,0,12,223
Sonoma,95402,56,18,1,3,78
Sonoma,95403,318,55,18,7,398
Sonoma,95404,295,101,0,23,419
Sonoma,95405,60,51,0,5,116
Sonoma,95406,9,5,0,0,14
Sonoma,95407,14,9,0,6,29
Sonoma,95409,33,76,0,9,118
Sonoma,95416,3,1,0,0,4
Sonoma,95421,3,5,0,0,8
Sonoma,95425,16,7,0,1,24
Sonoma,95433,1,0,0,0,1
Sonoma,95436,13,10,0,1,24
Sonoma,95439,0,1,0,1,2
Sonoma,95441,2,3,0,1,6
Sonoma,95442,10,20,0,1,31
Sonoma,95444,2,3,0,2,7
Sonoma,95446,7,9,0,4,20
Sonoma,95448,54,58,0,3,115
Sonoma,95450,0,1,0,2,3
Sonoma,95452,10,8,0,0,18
Sonoma,95462,3,6,0,1,10
Sonoma,95465,3,12,0,3,18
Sonoma,95472,71,69,0,8,148
Sonoma,95473,26,10,0,4,40
Sonoma,95476,84,84,0,13,181
Sonoma,95486,1,0,0,0,1
Sonoma,95487,0,4,0,0,4
Sonoma,95492,32,27,0,5,64
Sonoma,95497,2,7,0,1,10
Stanislaus,95307,7,1,0,0,8
Stanislaus,95313,0,1,0,0,1
Stanislaus,95316,1,0,0,1,2
Stanislaus,95319,1,1,0,0,2
Stanislaus,95326,3,1,0,0,4
Stanislaus,95329,1,0,0,0,1
Stanislaus,95350,32,11,0,5,48
Stanislaus,95351,4,0,0,1,5
Stanislaus,95352,10,1,0,0,11
Stanislaus,95353,42,14,8,3,67
Stanislaus,95354,317,18,13,5,353
Stanislaus,95355,26,18,0,4,48
Stanislaus,95356,17,11,0,3,31
Stanislaus,95357,17,11,0,1,29
Stanislaus,95358,4,1,0,0,5
Stanislaus,95360,0,1,0,0,1
Stanislaus,95361,12,13,1,0,26
Stanislaus,95363,5,2,0,1,8
Stanislaus,95367,1,4,0,0,5
Stanislaus,95368,4,2,0,0,6
Stanislaus,95380,14,7,0,1,22
Stanislaus,95381,11,1,0,1,13
Stanislaus,95382,11,7,0,2,20
Stanislaus,95386,0,1,0,0,1
Sutter,95659,2,1,0,0,3
Sutter,95668,2,0,0,0,2
Sutter,95674,0,0,0,1,1
Sutter,95676,1,0,0,0,1
Sutter,95953,2,1,0,0,3
Sutter,95982,0,1,0,0,1
Sutter,95991,47,12,0,3,62
Sutter,95992,6,3,0,1,10
Sutter,95993,38,16,5,2,61
Tehama,96021,6,3,0,0,9
Tehama,96035,1,0,0,0,1
Tehama,96055,2,2,0,0,4
Tehama,96059,0,1,0,0,1
Tehama,96063,0,1,0,0,1
Tehama,96078,1,0,0,0,1
Tehama,96080,43,13,4,4,64
Trinity,95595,0,1,0,0,1
Trinity,96024,2,1,0,0,3
Trinity,96041,0,3,0,3,6
Trinity,96046,0,0,0,1,1
Trinity,96048,0,1,0,0,1
Trinity,96091,1,0,0,0,1
Trinity,96093,12,5,2,0,19
Tulare,93207,0,1,0,0,1
Tulare,93208,0,0,0,1,1
Tulare,93221,6,4,0,1,11
Tulare,93223,0,0,0,1,1
Tulare,93227,0,1,0,0,1
Tulare,93247,2,1,0,0,3
Tulare,93256,1,1,0,0,2
Tulare,93257,19,5,1,0,25
Tulare,93258,1,0,0,1,2
Tulare,93260,0,0,0,1,1
Tulare,93261,0,1,0,0,1
Tulare,93265,1,2,0,0,3
Tulare,93270,0,1,0,1,2
Tulare,93271,9,5,0,0,14
Tulare,93274,14,4,1,0,19
Tulare,93275,2,0,0,0,2
Tulare,93277,52,15,0,2,69
Tulare,93278,2,1,0,0,3
Tulare,93279,5,2,1,1,9
Tulare,93286,0,1,0,0,1
Tulare,93290,14,2,0,2,18
Tulare,93291,226,23,15,4,268
Tulare,93292,6,4,0,0,10
Tulare,93618,5,1,0,0,6
Tuolumne,95310,1,0,0,0,1
Tuolumne,95321,2,4,0,0,6
Tuolumne,95327,3,0,0,0,3
Tuolumne,95335,3,0,0,1,4
Tuolumne,95346,3,1,0,0,4
Tuolumne,95364,0,1,0,0,1
Tuolumne,95370,52,25,3,5,85
Tuolumne,95372,0,2,0,0,2
Tuolumne,95373,1,1,0,0,2
Tuolumne,95379,0,1,0,0,1
Tuolumne,95383,2,7,0,1,10
Ventura,91319,7,4,0,1,12
Ventura,91320,153,46,0,9,208
Ventura,91358,5,5,0,0,10
Ventura,91359,48,11,0,5,64
Ventura,91360,151,55,0,20,226
Ventura,91361,496,58,0,13,567
Ventura,91362,358,86,0,17,461
Ventura,91377,45,28,0,5,78
Ventura,93001,138,51,3,11,203
Ventura,93002,10,9,0,1,20
Ventura,93003,292,108,2,20,422
Ventura,93004,53,29,0,5,87
Ventura,93005,7,0,0,1,8
Ventura,93006,33,12,9,5,59
Ventura,93007,2,1,0,1,4
Ventura,93009,196,9,16,1,222
Ventura,93010,115,56,0,14,185
Ventura,93011,18,16,0,0,34
Ventura,93012,83,52,0,12,147
Ventura,93015,4,3,0,0,7
Ventura,93016,2,1,0,0,3
Ventura,93020,4,2,0,0,6
Ventura,93021,53,26,0,8,87
Ventura,93022,7,10,0,2,19
Ventura,93023,59,53,0,9,121
Ventura,93024,7,9,0,2,18
Ventura,93030,57,16,0,7,80
Ventura,93031,15,7,0,0,22
Ventura,93032,2,1,0,0,3
Ventura,93033,5,4,0,0,9
Ventura,93034,2,0,0,1,3
Ventura,93035,43,60,0,4,107
Ventura,93036,120,22,1,3,146
Ventura,93040,1,0,0,0,1
Ventura,93041,8,11,0,4,23
Ventura,93042,1,0,0,0,1
Ventura,93043,4,1,0,1,6
Ventura,93044,4,2,0,1,7
Ventura,93060,20,10,0,4,34
Ventura,93061,1,1,0,0,2
Ventura,93062,12,3,0,1,16
Ventura,93063,73,25,0,3,101
Ventura,93065,103,35,0,18,156
Ventura,93066,12,8,0,2,22
Ventura,93094,4,0,0,1,5
Yolo,95605,66,7,0,1,74
Yolo,95606,2,0,0,0,2
Yolo,95612,3,1,0,1,5
Yolo,95616,185,187,0,34,406
Yolo,95617,27,30,0,3,60
Yolo,95618,70,77,0,5,152
Yolo,95627,1,1,0,1,3
Yolo,95637,1,1,0,0,2
Yolo,95653,1,0,0,0,1
Yolo,95679,0,2,0,0,2
Yolo,95691,47,31,0,9,87
Yolo,95694,10,8,0,0,18
Yolo,95695,142,28,10,5,185
Yolo,95698,1,1,0,0,2
Yolo,95776,34,8,0,2,44
Yolo,95798,39,1,0,0,40
Yolo,95937,2,0,0,0,2
Yuba,95692,3,3,0,0,6
Yuba,95901,65,11,5,1,82
Yuba,95903,1,0,0,0,1
Yuba,95918,1,3,0,1,5
Yuba,95922,1,0,0,1,2
Yuba,95961,7,1,0,0,8
Yuba,95962,1,1,0,0,2
Yuba,95977,0,0,0,1,1